00000000000000000000000000000000
01 2 3 n n n n n n n n n n n n 0
01 e 5 n n n n n n n n n n n n 0
01 n 4 n n n n n 2 2 2 2 2 2 2 0        
01 2 3 n n n n n 4 2 1 e 1 h 1 0
0n n n n n n n n 4 3 1 n 1 2 2 0
0n n n n n n n n 4 1 1 p 1 3 4 0
0n n n n n n n n h 5 3 h 4 1 p 0
0n n n n n n n n n n n n n n n 0
01 6 5 2 1 6 n n n n n n n 1 1 0
02 4 1 q 4 33n n n n n n n e 320
04 e 3 p 3 2 n n n n n n n n 2 0
04 n 2 h 4 p n n n n n n p 3 4 0
01 6 1 3 5 3 n n n n n n n n n 0
0                              0
0                              0
0                              0
0                              0
0                              0
0                              0
0                              0
0                              0
0                              0
0                              0
0                              0
0                              0
0                              0
0                              0
0                              0
0                              0