00000000000000000000000000000000
01 1 h 1 2 h h h h 4 2 2 2 4 3 0
0                              0
06 6 6 6 6 6 6 6 6 6 6 6 6 6 6 0
0                              0
0n n n n n n n e n n n n n n n 0
0                              0
01 1 1 1 1 1 1 1 1 1 1 1 1 1 1 0
0                              0
0n n n h n n n n n n n n p n n 0
0                              0
0                              0
0                              0
0                              0
0                              0
0                              0
0                              0
0                              0
0                              0
0                              0
0                              0
0                              0
0                              0
0                              0
0                              0
0                              0
0                              0
0                              0
0                              0
0                              0